111111111111111111111111111111
100000000000000000000000000001
100000000000000000000000000001
100000000000000000000000000001
100000000000000000000000000001
100001111000000000000111100001
100001000000000000000000100001
100001000000000000000000100001
100001000000000000000000100001
100000000000000000000000000001
100000000000000000000000000001
100001000000000000000000100001
100001000000000000000000100001
100001000000000000000000100001
100001111000000000000111100001
100000000000000000000000000001
100000000000000000000000000001
100000000000000000000000000001
100000000000000000000000000001
111111111111111111111111111111
#2#2#1#0#10