111111111111111111111111111111
100000000000001100000000000001
100000000000001100000000000001
100000000000001100000000000001
100000000000001100000000000001
100001111100001100001101100001
100000000000001100001101100001
100001111100001100001101100001
100000000000001100000000000001
100000000000000000000000000001
100000000000000000000000000001
100000000000001100000000000001
100001101100001100001111100001
100001101100001100000000000001
100001101100001100001111100001
100000000000001100000000000001
100000000000001100000000000001
100000000000001100000000000001
100000000000001100000000000001
111111111111111111111111111111
#2#2#0#1#15