100001111111111111111111100001
100000000000000000000000100001
100000000000000000000000100001
100000000000000000000000100001
100000000000000000000000100001
111111111111111100000000100001
100001000000000100000000100001
100001000000000100000000100001
100001000000000100000000100001
100001000000000100000000100001
100001000000000100000000100001
100001000000000000000000100001
100001000000000000000000100001
100001000000000000000000100001
100001111111111111111111111111
100000000000000000000000000001
100000000000000000000000000001
100000000000000000000000000001
100000000000000000000000000001
100001111111111111111111100001
#2#2#1#0#20