111111000010000111111000011111
100000000010000000001000000001
100000000010000000001000000001
100000000010000000001000000001
100000000010000000001111110001
100001111111111100001000000001
100001000000000100001000000001
100001000000000100001000000001
100001000000000100001000011111
000001000000000100001000010000
000001000010000100001000010000
000001000010000100001000010000
100001000010000100001000011111
100001000010000100001000000001
100001000010000100001000000001
100001000010000100001111110001
000001000010000100000000010000
000001000010000100000000010000
000001000010000100000000010000
111111000010000111111000011111
#2#2#0#1#25