111111111111111111111111111111
100000000000000000000000000001
100000000000000000000000000001
100001111100010010011100000001
100000010000010010010000000001
100000010000011110011100000001
100000010000010010010000000001
100000010000010010011100000001
100000000000000000000000000001
100000000000000000000000000001
100000111001000100110000000001
100000100001100100101000000001
100000111001010100101000000001
100000100001010100101000000001
100000111001001100110000000001
100000000000000000000000000001
100000000000000000000000000001
100000000000000000000000000001
100000000000000000000000000001
111111111111111111111111111111
#3#17#1#0#0